++++++++++++++++++++++
+   +   ++ ++    ++  +
      +     ++++++++++
+ +    ++  ++++ +++ ++
+ +   + + ++    +++  +
+          ++  ++  + +
+++++ + +      ++  + +
+++++ +++  + +  ++   +
+          + + S+ +  +
+++++ +  + +++  ++ + +
++++++++++++++++++++++